{
"a1" : {"x":"114","y":"601"},
"b1" : {"x":"187","y":"593"},
"c1" : {"x":"262","y":"597"},
"d1" : {"x":"331","y":"596"},
"e1" : {"x":"406","y":"594"},
"f1" : {"x":"483","y":"591"},
"g1" : {"x":"553","y":"596"},
"h1" : {"x":"629","y":"593"},
"a2" : {"x":"114","y":"525"},
"b2" : {"x":"189","y":"522"},
"c2" : {"x":"266","y":"526"},
"d2" : {"x":"336","y":"522"},
"e2" : {"x":"412","y":"525"},
"f2" : {"x":"484","y":"528"},
"g2" : {"x":"561","y":"526"},
"h2" : {"x":"632","y":"522"},
"a3" : {"x":"118","y":"452"},
"b3" : {"x":"192","y":"451"},
"c3" : {"x":"266","y":"451"},
"d3" : {"x":"334","y":"455"},
"e3" : {"x":"418","y":"440"},
"f3" : {"x":"484","y":"452"},
"g3" : {"x":"562","y":"448"},
"h3" : {"x":"623","y":"454"},
"a4" : {"x":"110","y":"383"},
"b4" : {"x":"190","y":"385"},
"c4" : {"x":"256","y":"379"},
"d4" : {"x":"332","y":"377"},
"e4" : {"x":"404","y":"379"},
"f4" : {"x":"488","y":"381"},
"g4" : {"x":"548","y":"378"},
"h4" : {"x":"634","y":"377"},
"a5" : {"x":"117","y":"296"},
"b5" : {"x":"191","y":"307"},
"c5" : {"x":"257","y":"299"},
"d5" : {"x":"335","y":"300"},
"e5" : {"x":"410","y":"304"},
"f5" : {"x":"480","y":"303"},
"g5" : {"x":"559","y":"302"},
"h5" : {"x":"623","y":"302"},
"a6" : {"x":"114","y":"225"},
"b6" : {"x":"179","y":"224"},
"c6" : {"x":"256","y":"228"},
"d6" : {"x":"334","y":"230"},
"e6" : {"x":"405","y":"229"},
"f6" : {"x":"483","y":"225"},
"g6" : {"x":"553","y":"232"},
"h6" : {"x":"640","y":"230"},
"a7" : {"x":"122","y":"161"},
"b7" : {"x":"181","y":"160"},
"c7" : {"x":"263","y":"163"},
"d7" : {"x":"336","y":"161"},
"e7" : {"x":"408","y":"164"},
"f7" : {"x":"486","y":"163"},
"g7" : {"x":"552","y":"162"},
"h7" : {"x":"626","y":"160"},
"a8" : {"x":"110","y":"77"},
"b8" : {"x":"191","y":"83"},
"c8" : {"x":"262","y":"76"},
"d8" : {"x":"339","y":"86"},
"e8" : {"x":"406","y":"90"},
"f8" : {"x":"485","y":"83"},
"g8" : {"x":"558","y":"85"},
"h8" : {"x":"626","y":"87"}
}
